00000000
00111000
01110000
00000000
00000000
00000000
00000000
00000000
00000000
